###################..
#...........#........
###.#.#.#####.###.#.#
#.#.#.#.......#...#.#
#.#####.#####.#####.#
#.....#.....#...#...#
#.#.#######.#####.###
#.#.#.#.#.#.#.......#
###.#.#.#.#####.###.#
#.............#.#.#.#
###.#.#.#.#####.#.#.#
#...#.#.#...#...#...#
#.#########.#######.#
#...#.#.#...#...#...#
#.###.#.#.###.###.###
#.......#.....#...#.#
#.###########.#.#.#.#
#.#.#...#.#.....#.#.#
#.#.#.#.#.#.###.###.#
......#.#...#.......#
..###################