#########..
#...#.#....
#.#.#.###.#
#.#.#.#...#
#.#.#.###.#
#.#...#...#
..#...###.#
..#...#.#.#
#...#.#.#.#
..........#
.....######