#################################..
#.#.........#.#.....#..............
#.#######.###.###.#####.#####.#####
#.#.......#.#.......#.....#.......#
#.#.#.###.#.#####.#.#########.###.#
#.#.#.#.#.....#...#.#.#.#...#.#...#
#.#.###.#####.#####.#.#.###.###.#.#
#.#...#.#.....#.......#...#.#...#.#
#.#.#.#.#####.###.#######.#.#.###.#
#...#.....#.....#.#.....#.#.#.#...#
#.###.#######.#.#.#.###.#.#.#.#####
#.#.....#.#...#...#.#.............#
#####.###.#####.#######.###.#.###.#
#...#...#.#.......#.......#.#.#.#.#
#.#####.#.#####.#######.#######.###
#.#.....#.#.#...#...........#.#.#.#
#.#.#####.#.#####.#.#####.###.#.#.#
#.#.#.......#.....#.#...#...#...#.#
#.#.#.#.###########.###.#.#####.#.#
#.#...#.#.....#.....#...#.........#
#.#####.#.###.#.#####.#.###.#######
#...#...#.#.#.#.....#.#.#.#.#.#...#
#.#.###.#.#.#####.###.#.#.#.#.#.###
#.#.#.#.#...#.....#.#.#...#.#.....#
#.#.#.#.#.#########.#.#.#.#.#.#.###
#.#.#.#.......#.#.....#.#...#.#...#
###.#.###.#####.#.#######.###.#####
#.#.#.....#...#.......#.......#...#
#.#.#.###.###.#.#############.###.#
#...#...#.....#.#.#.#.#.#.....#...#
###.#.###.###.#.#.#.#.#.#.#####.###
#.......#...#.......#...#.........#
#.###.#####.#.#.#.###.#########.#.#
....#.....#.#.#.#.........#.....#.#
..#################################